101
==A...........
==............
==............
==............
==............
==............
==............
==............
==............
==............
==-...........
==--..........
==---.........
==---.........
..............
..............
-----.........
..............
..............
..............
..............
---...........
..|...........
..|...........
..|...0.......
..|...0.......
..|...0.......
..|...0.......
..|...........
..|...........
..|...........
..|...........
..|...........
..|...........
..|...........
---...........
..............
.........0....
.........0....
.........0....
-----.........
....|.........
....|.........
....|.........
....|.........
....|.........
....|..k......
....|.........
-----.........
..............
..............
..............
---...........
..|...........
..|...........
..|...........
..|...........
..|...........
..|...........
..|...........
..|...........
..|...........
..|...........
..|...........
..|...........
..|...........
..|...........
---...........
..............
..............
..............
..............
..............
....|.........
....|.........
....|.........
..............
..............
..............
..|...........
..|...........
..............
..............
....|.........
....|.........
..............
..............
..............
........K!....
..............
..|...........
..|...........
..|...........
..............
..............
..............
..............
..............
---...........
..|...........
..|...........
..|...........
..|...........
..|..k........
..|...........
..|...........
---...........
..|...........
..|...0.......
..|...0.......
..|...0.......
..|...0.......
..|...........
..|..k........
..|...........
..|...........
..|...0.......
..|...0.......
..|...0.......
..|...0.......
..|...........
..|...........
---...........
..............
..............
..............
..............
..............
.I............
.I............
.I............
.I............
.I...b........
.I...k........
.I............
..............
..............
..............
..............
..............
.....I........
.....I........
.....I........
..............
..............
..............
..............
..|...........
..|...........
..|...........
..............
..............
..............
..|...........
..|...........
..............
..............
....|.........
....|.........
....|.........
..............
..............
..............
..............
..|...........
..|...........
..|...........
..............
..............
..............
..............
....|.........
....|.........
....|.........
..............
..............
..............
....|.........
....|.........
..............
..............
---...........
..|...........
..|...0.......
..|...0.......
..|...0.......
..|...0.......
---...........
..............
....|.........
....|.........
....|.........
..............
..............
..............
..............
..........K...
..............
..............
.........I....
.........I....
.........I....
..............
..............
..............
..............
.........I....
.........I....
.........I....
..............
..............
..............
..............
..............
..............
..........K...
..............
==F...........
==............
==............
==............
==............
==A...........
